222222222222222222222222222222222222222222222222222222222222222
200000000000000000000000000000000000000000000000000000000000002
200000000000000000000000000000000000000000000000000000000000002
200000000000000000000000000000000000000000000000000000000000002
200000000000000000000000000000000000000000000000000000000000002
200000000000000000000000000000000000000000000000000000000000002
200000000000000000000000000000000000000000000000000000000000002
200000000000000000000000000000000000000000000000000000000000002
200000000000000000000000000000000000000000000000000000000000002
200000000000000000000000000000000000000000000000000000000000002
200000000000000000000000000000000000000000000000000000000000002
200000000000000000000000000000000000000000000000000000000000002
200000000000000000000000000000000000000000000000000000000000002
200000000000000000000000000000000000000000000000000000000000002
200000000000000000000000000000000000000000000000000000000000002
200000000000000000000000000055555515555555000000000000000000002
200000000000000000000000000055555000555555000000000000000000002
200000000000000000000000000000555000555555000000000000000000002
200000000000000000000000000000555000550000000000000000000000002
200000000000000000000000000000555000550000000000000000000000002
200000000000000000000000005555555000555500000000000000000000002
200000000000000000000000005555555000555500000000000000000000002
200000000000000000000000005500100000005500000000000000000000002
200000000000000000000000005500555000555500000000000000000000002
200000000000000000000000005500555000555500000000000000000000002
200000000000000000000000005500555000555500000000000000000000002
200000000000000000000000005555555000550000000000000000000000002
200000000000000000000000005555555000550000000000000044444444444
200000000000000000000000000000055505550000000000000044444444444
200000000000000000000000003333330000033333330000000044000000004
200000000000000000000000003000000000000000334444444444000000004
200000000000000000000000001000000000000000144444444444000000004
200000000000000000000000003000000000000000040000000004000000004
200000000000000000000000003000000000000000000000000000000000004
200000000000000000000000003000000000000000040000000004000000004
200000000000000000000000001000000000000000144400004444000000004
200000000000000000000000003000000000000000330440044004000000004
200000000000000000000000003333330000033333330440044004000000004
200000000000000000000000000000034404440000000440044004444444444
200000000000000000000000000000044000440000000440044000000000002
200000000000000000000000000000044000440000000440044000000000002
200000000000000000000000000000044000440000000440044444444444442
200000000000000000000000000000044000440000000440044404040404442
200000000000000000000000000000044000440000000440004000000000042
200000000000000000000000000000044000440000000440000000000000042
200000000000000000000000000000044000440000000440004000000000042
200000000000000000000000000000044000440000000444444404040404442
200000000000000000000000000000044000440000000444444444444444442
200000000000000000000000000000044000440000000000000000000000002
200000000000000000000000000000044000440000000000000000000000002
200000000000000000000000004444444404444444400000000000000000002
200000000000000000000000004400004000400004400000000000000000002
200000000000000000000000004400000000000004400000000000000000002
200000000000000000000000004400004000400004400000000000000000002
200000000000000000000000004400004000400004400000000000000000002
200000000000000000000000004444444000444444400000000000000000002
200000000000000000000000004400004000400004400000000000000000002
200000000000000000000000004400000000000004400000000000000000002
200000000000000000000000004400004000400004400000000000000000002
200000000000000000000000004444444000444444400000000000000000002
200000000000000000000000004400000000000004400000000000000000002
200000000000000000000000004400000000000004400000000000000000002
200000000000000000000000004400000000000004400000000000000000002
222222222222222222222222224444444444444444422222222222222222222