222222222222222222222222222222222222222222222222222222222222222
200000000000000000000000000000000000000000000000000000000000002
200000000000000000000000000000000000000000000000000000000000002
200000000000000000000000000000000000000000000000000000000000002
200000000000000000000000000000000000000000000000000000000000002
200000000000000000000000000000000000000000000000000000000000002
200000000000000000000000000000000000000000000000000000000000002
200000000000000000000000000000000000000000000000000000000000002
200000000000000000000000000000000000000000000000000000000000002
200000000000000000000000000000000000000000000000000000000000002
200000000000000000000000000000000000000000000000000000000000002
200000000000000000000000000000000000000000000000000000000000002
200000000000000000000000000000000000000000000000000000000000002
200000000000000000000000000000000000000000000000000000000000002
200000000000000000000000000000000000000000000000000000000000002
200000000000000000000000000055555515555555000000000000000000002
200000000000000000000000000055555000555555000000000000000000002
200000000000000000000000000000555000555555000000000000000000002
200000000000000000000000000000555000550000000000000000000000002
200000000000000000000000000000555000550000000000000000000000002
200000000000000000000000005555555000555500000000000000000000002
200000000000000000000000005555555000555500000000000000000000002
200000000000000000000000005500100000005500000000000000000000002
200000000000000000000000005500555000555500000000000000000000002
200000000000000000000000005500555000555500000000000000000000002
200000000000000000000000005500555000555500000000000000000000002
200000000000000000000000005555555000550000000000000000000000002
200000000000000000000000005555555000550000000000000000000000002
200000000000000000000000000000055505550000000000000000000000002
200000000000000000000000003333330000033333330000000000000000002
200000000000000000000000003000000000000000330000000000000000002
200000000000000000000000001000000000000000140000000000000000002
200000000000000000000000003000000000000000041000000000000000002
200000000000000000000000003000000000000000001000000000000000002
200000000000000000000000003000000000000000041000000000000000002
200000000000000000000000001000000000000000140000000000000000002
200000000000000000000000003000000000000000330000000000000000002
200000000000000000000000003333330000033333330000000000000000002
200000000000000000000000000000034404440000000000000000000000002
200000000000000000000000000000044000440000000000000000000000002
200000000000000000000000000000044000440000000000000000000000002
200000000000000000000000000000044000440000000000000000000000002
200000000000000000000000000000044000440000000000000000000000002
200000000000000000000000000000044000440000000000000000000000002
200000000000000000000000000000044000440000000000000000000000002
200000000000000000000000000000044000440000000000000000000000002
200000000000000000000000000000044000440000000000000000000000002
200000000000000000000000000000044000440000000000000000000000002
200000000000000000000000000000044000440000000000000000000000002
200000000000000000000000000000044000440000000000000000000000002
200000000000000000000000004444444404444444400000000000000000002
200000000000000000000000004400004000400004400000000000000000002
200000000000000000000000004400000000000004400000000000000000002
200000000000000000000000004400004000400004400000000000000000002
200000000000000000000000004400004000400004400000000000000000002
200000000000000000000000004444444000444444400000000000000000002
200000000000000000000000004400004000400004400000000000000000002
200000000000000000000000004400000000000004400000000000000000002
200000000000000000000000004400004000400004400000000000000000002
200000000000000000000000004444444000444444400000000000000000002
200000000000000000000000004400000000000004400000000000000000002
200000000000000000000000004400000000000004400000000000000000002
200000000000000000000000004400000000000004400000000000000000002
222222222222222222222222224444444444444444422222222222222222222