00000000000000000000000000003330000000000000000000000000
00000000000000000000003331333033333333000000000000000000
00000000000333333313331000000000000003000000000000000000
00000000000300000000003000000000100003000000000000000000
00000000000100000000000000000000300003000000000000000000
00000000000300000000003000000000300003000000000000000000
00000000000300033313331000000000333333000000000000000000
00000000000300030000003000000000300000000000000000000000
00000000013300033300003333333033300000000000000000000000
00000000030000000300000000300000300000000000000000000000
00000000010000000300000000300000300000000000000000000000
00000000030000000300000000300000300000000000000000000000
00000000013331333300000000300000300000000000000000000000
00000000000000000000000000300000300000000000000000000000
00000000000000000000000000300000333000000000000000000000
00000000000000000000000000300000003000000000000000000000
00000000000000000000000000300000333000000000000000000000
00000000000000000000000000300000300000000000000000000000
00000000000000000000000000300000300000000000000000000000
00000000000000000000000000300000300000000000000000000000
00000000000000000000000000300000300000000000000000000000
00000000000000000000000000322022300000000000000000000000
00000000000000000000000033300000333000000000000000000000
00000000000000000000000030000000003000000000000000000000
00000000000000000000000030000000003000000000000000000000
00000000000000000000000030000000003200000000000000000000
00000000000000000000000030000000000200000000000000000000
00000000000000000000000030000000000100000000000000000000
00000000000000000000000030000000000200000000000000000000
00000000000000000000000030000000003200000000000000000000
00000000000000000000000033300000333000000000000000000000
00000000000000000000000000322022300000000000000000000000
00000000000000000000000000020002000000000000000000000000
00000000000000000000000000020002000000000000000000000000
00000000000000000000000000020002000000000000000000000000
00000000000000000000000000200000200000000000000000000000
00000000000000000000000000020002000000000000000000000000
00000000000000000000000000020002000000000000000000000000
00000000000000000000000000020002000000000000000000000000
00000000000000000000000000021012000000000000000000000000
00000000000000000000000000020002000000000000000000000000
00000000000000000000000000020002000000000000000000000000
00000000000000000000000000020002000000000000000000000000
00000000000000000000000000020002000000000000000000000000
00000000000000000000000000020002000000000000000000000000
00000000000000000000000000020002000000000000000000000000
00000000000000000000000000020002000000000000000000000000
00000000000000000000000000020002000000000000000000000000
00000000000000000000000000222022200000000000000000000000
00000000000000000000000000200000200000000000000000000000
00000000000000000000000000200000200000000000000000000000
00000000000000000000000000222122200000000000000000000000
